Player	Lg	Count
Kareem Abdul-Jabbar	NBA	6
Michael Jordan	NBA	5
Bill Russell	NBA	5
Wilt Chamberlain	NBA	4
LeBron James	NBA	4
Larry Bird	NBA	3
Julius Erving	ABA	3
Magic Johnson	NBA	3
Moses Malone	NBA	3
Giannis Antetokounmpo	NBA	2
Stephen Curry	NBA	2
Mel Daniels	ABA	2
Tim Duncan	NBA	2
Karl Malone	NBA	2
Steve Nash	NBA	2
Bob Pettit	NBA	2
Charles Barkley	NBA	1
Kobe Bryant	NBA	1
Bob Cousy	NBA	1
Dave Cowens	NBA	1
Billy Cunningham	ABA	1
Kevin Durant	NBA	1
Julius Erving	NBA	1
Kevin Garnett	NBA	1
Artis Gilmore	ABA	1
James Harden	NBA	1
Connie Hawkins	ABA	1
Spencer Haywood	ABA	1
Allen Iverson	NBA	1
Bob McAdoo	NBA	1
Player	Lg	Count
George McGinnis	ABA	1
Dirk Nowitzki	NBA	1
Shaquille O'Neal	NBA	1
Hakeem Olajuwon	NBA	1
Willis Reed	NBA	1
Oscar Robertson	NBA	1
David Robinson	NBA	1
Derrick Rose	NBA	1
Wes Unseld	NBA	1
Bill Walton	NBA	1
Russell Westbrook	NBA	1